1111111111111111111111111111111111
100000000000000C00000C000000000001
1010010100100000101001000000010001
1010010010101010001001000000110001
1P0000000C00C0000000000000011110C1
1111111111111111111111111111111011
10000000000000000000000C0000000001
1011111111111111111111111111111111
1000000000000000C00000000000000001
1111111111111111111111111111111101
1000000000000000C00000000000000001
1000000111111111111111111111111111
1000000000000000000000000000000001
1000000000000000000000000000000001
1000000000000000000000000000000001
1000000000000000000000000000000001
1000000000000000000000000000000001
1000000000000000000000000000000001
1000000000000000000000000000000001
1000000000000000000000000000000001
1C00000000000000000000000000000001
1C000000C00000000000000000000000E1
1111111111111111111111111111111111